NO        ./textures/stone_wall.xpm
SO        ./textures/stone_wall_2.xpm          
EA        ./textures/stone_wood.xpm
WE        ./textures/wooden_w.xpm

C  000,000,000
F  225,225,225

11111111111111111111111111111111
10000000000000000000000000000001
10000000000000000000000000000001
10000000000000000000000000000001111
100000000000000000000000000000000W01
111111111111111111111111111111111111